NO    ./texture/grey.xpm
SO    ./texture/redbrick.xpm
WE    ./texture/mossy_w.xpm
EA    ./texture/wood.xpm

F 74,79, 90
C 195, 231, 245
1111111111111111111111111
1000100000110000000000001
1000100001110000000000001
1111000000000000000000001
11111111101100000111000011111
10000000001100000111011111111
11110111111111011100000010001
1111011111111101110101001000111
110000001101010111000000100011011
100000000000000000000000100010001
100000000000000011010100000000001
1100000111010101111101111N0011111
11110111 1110101 101111010001
11111111 1111111 1111111111111
0